25 25
#########################
#OOOOOOOOOOOOOOOOOOOOOOO#
#OOOOOOOOOOOOOOOOOOOOOOO#
#OOOOOOOOOOOOOOOOOOOOOOO#
#OOOOOOOOOOOOOOOOOOOOOOO#
#OOOOOOOOOOOOOOOOOOOOOOO#
#OOOOOOOOOOOOOOOOOOOOOOO#
#OOOOOOOOOOOOOOOOOOOOOOO#
#OOOOOOOOOOOOOOOOOOOOOOO#
#OOOOOOOOOOOOOOOOOOOOOOO#
#OOOOOOOOOOOOOOOOOOOOOOO#
#OOOOOOOOOOOOOOOOOOOOOOO#
#OOOOOOOOOOHOOOOOOOOOOOO#
#OOOOOOOOOOOOOOOOOOOOOOO#
#OOOOOOOOOOOOOOOOOOOOOOO#
#OOOOOOOOOOOOOOOOOOOOOOO#
#OOOOOOOOOOOOOOOOOOOOOOO#
#OOOOOOOOOOOOOOOOOOOOOOO#
#OOOOOOOOOOOOOOOOOOOOOOO#
#OOOOOOOOOOOOOOOOOOOOOOO#
#OOOOOOOOOOOOOOOOOOOOOOO#
#OOOOOOOOOOOOOOOOOOOOOOO#
#OOOOOOOOOOOOOOOOOOOOOOO#
#OOOOOOOOOOOOOOOOOOOOOOO#
#########################